40,18
# The first line is ALWAYS THE MAP SIZE
# This is a ultra simple config language for my game
# Comments starts with a "#"

enemy:
# id=(height,width,sight,hearing,attacking_range,walking_speed,stalking_speed,attacking_speed)
E1=(15,10,350,250,150,1,1.5,2)

npc:
define:N1,10,15
dialogue:N1,"Hello there, traveler."
dialogue:N1,"I've been waiting for you."
dialogue:N1,"Be careful out there."

map:
1111111111111111111111111111111111111111
1P00000000000000000000000000000000000001
1000000000000000000000000000000000000001
1000111110000000000001111100000000000001
1000100000000000000000000100000000000001
1000100000000000000000000100000000000001
10001000N1000000000N20000100000000000001
1000111110000000000001111100000000000001
1000000000000000000000000000000000000001
1000000000000111111110000000000000000001
1000000000000100000010000000000000000001
1000000000000100000010000000000000000001
1000000000000100000010000000000000000001
1000000000000111111110000000000000000001
1000000000000000000000000000000000000001
1000000000000000000000000000000000000001
1000000000000000000000000000000000000001
1111111111111111111111111111111111111111
