E=1
NPC=0
1111111111111111111111111111111111111111
1000000000000000000000100000000000000001
1000000000000000000000100000000000000001
1000000000000000000000111110000000000001
1000100000000000000000000010000000000001
1000100000000000000000000010000000000001
1000100000000000000000000010000000000001
1000100000000000000000000011111100011111
1000100000000000000000000000000000000001
1000100000000000000000000000000000000001
1000100000000000000000000000000000000001
1000111111111111111111111111111111100001
1000000000000000000000000000000000000001
1000000000000000000000000000000000000001
1000000000000000000000000000000000000001
1000000000000000000000000000000000000001
1000000000000000000000000000000000000001
1111111111111111111111100000000000000001
1000000000000000000000100000000000000001
1000000000000000000000100000000000000001
1000000000000000000000100000000000000001
1000000000000000000000111111111111110001
1000000000000000000000100000000000000001
1000000000000000000000100000000000000001
1000000000000000000000100000000000000001
1000000000000000000000100000000000000001
1000000000000000000000100000000000000001
1000000000000000000000000000000000000001
1000000000000000000000000000000000000001
1111111111111111111111111111111111111111

